{
  "patterns": [
    {
      "name": "hearts",
      "pattern": [
        [0, 0, 0, 0, 0, 0, 0, 0, 0, 0, 0, 0, 0, 0, 0],
        [0, 0, 0, 0, 0, 0, 0, 0, 0, 0, 0, 0, 0, 0, 0],
        [0, 0, 0, 1, 1, 1, 0, 0, 0, 1, 1, 1, 0, 0, 0],
        [0, 0, 1, 1, 1, 1, 1, 0, 1, 1, 1, 1, 1, 0, 0],
        [0, 1, 1, 1, 1, 1, 1, 1, 1, 1, 1, 1, 1, 1, 0],
        [0, 1, 1, 1, 1, 1, 1, 1, 1, 1, 1, 1, 1, 1, 0],
        [0, 1, 1, 1, 1, 1, 1, 1, 1, 1, 1, 1, 1, 1, 0],
        [0, 0, 1, 1, 1, 1, 1, 1, 1, 1, 1, 1, 1, 0, 0],
        [0, 0, 1, 1, 1, 1, 1, 1, 1, 1, 1, 1, 1, 0, 0],
        [0, 0, 0, 1, 1, 1, 1, 1, 1, 1, 1, 1, 0, 0, 0],
        [0, 0, 0, 0, 1, 1, 1, 1, 1, 1, 1, 0, 0, 0, 0],
        [0, 0, 0, 0, 0, 1, 1, 1, 1, 1, 0, 0, 0, 0, 0],
        [0, 0, 0, 0, 0, 0, 1, 1, 1, 0, 0, 0, 0, 0, 0],
        [0, 0, 0, 0, 0, 0, 0, 1, 0, 0, 0, 0, 0, 0, 0],
        [0, 0, 0, 0, 0, 0, 0, 0, 0, 0, 0, 0, 0, 0, 0]
      ]
    },
    {
      "name": "smiley",
      "pattern": [
        [0, 0, 0, 0, 0, 0, 0, 0],
        [0, 1, 1, 0, 0, 1, 1, 0],
        [0, 1, 1, 0, 0, 1, 1, 0],
        [0, 0, 0, 0, 0, 0, 0, 0],
        [0, 0, 0, 0, 0, 0, 0, 0],
        [0, 1, 0, 0, 0, 0, 1, 0],
        [0, 0, 1, 1, 1, 1, 0, 0],
        [0, 0, 0, 0, 0, 0, 0, 0]
      ]
    },
    {
      "name": "bmo",
      "pattern": [[1, 0, 1, 0, 1,1, 0, 0, 0, 0,0, 0, 0, 0, 0,0, 0, 0, 0, 0,0, 0, 0, 0, 0,0, 0, 0, 0, 0,1, 1, 0, 1, 0,1, 0],
        [1, 0, 1, 0, 1,1, 0, 0, 0, 1,1, 1, 1, 1, 1,1, 1, 1, 1, 1,1, 1, 1, 1, 1,1, 0, 0, 0, 0,1, 1, 0, 1, 0,1, 0],
        [1, 0, 1, 0, 1,1, 0, 0, 1, 0,0, 0, 0, 0, 0,0, 0, 0, 0, 0,0, 0, 0, 0, 0,0, 1, 0, 0, 0,1, 1, 0, 1, 0,1, 0],
        [1, 0, 1, 0, 1,1, 0, 1, 0, 1,0, 0, 0, 0, 0,0, 0, 0, 0, 0,0, 0, 0, 0, 0,0, 0, 1, 0, 0,1, 1, 0, 1, 0,1, 0],
        [1, 0, 1, 0, 1,1, 0, 1, 0, 0,1, 0, 0, 0, 0,0, 0, 0, 0, 0,0, 0, 0, 0, 0,0, 0, 0, 1, 0,1, 1, 0, 1, 0,1, 1],
        [0, 0, 1, 0, 1,1, 0, 1, 0, 0,0, 1, 1, 1, 1,1, 1, 1, 1, 1,1, 1, 1, 1, 1,1, 1, 0, 1, 0,1, 1, 0, 1, 0,0, 0],
        [1, 0, 1, 0, 1,1, 0, 1, 0, 0,1, 0, 0, 0, 0,0, 0, 0, 0, 0,0, 0, 0, 0, 0,0, 0, 0, 1, 0,1, 1, 0, 1, 0,1, 1],
        [0, 0, 1, 0, 1,1, 0, 1, 0, 0,0, 1, 1, 1, 1,1, 1, 1, 1, 1,1, 1, 1, 1, 1,1, 1, 0, 1, 0,1, 1, 0, 1, 0,0, 0],
        [1, 1, 1, 0, 1,1, 0, 1, 0, 1,0, 1, 0, 0, 0,0, 0, 0, 0, 0,0, 0, 0, 0, 0,0, 1, 0, 1, 0,1, 1, 0, 1, 1,1, 1],
        [0, 0, 0, 0, 1,1, 0, 1, 0, 0,0, 1, 0, 0, 0,0, 0, 0, 0, 0,0, 0, 0, 0, 0,0, 1, 0, 1, 0,1, 1, 0, 0, 0,0, 0],
        [1, 1, 1, 1, 1,1, 0, 1, 0, 1,0, 1, 0, 0, 1,0, 0, 0, 0, 0,0, 0, 0, 1, 0,0, 1, 0, 1, 0,1, 1, 1, 1, 1,1, 1],
        [1, 1, 1, 1, 1,1, 0, 1, 0, 0,0, 1, 0, 0, 1,0, 0, 0, 0, 0,0, 0, 0, 1, 0,0, 1, 0, 1, 0,1, 1, 1, 1, 1,1, 1],
        [0, 0, 0, 0, 0,0, 0, 1, 0, 1,0, 1, 0, 0, 0,0, 0, 0, 0, 0,0, 0, 0, 0, 0,0, 1, 0, 1, 0,0, 0, 0, 0, 0,0, 0],
        [0, 1, 1, 0, 0,0, 0, 1, 0, 0,0, 1, 0, 0, 0,0, 1, 0, 0, 0,0, 1, 0, 0, 0,0, 1, 0, 1, 0,0, 0, 0, 0, 1,1, 0],
        [0, 1, 1, 1, 0,0, 0, 1, 0, 1,0, 1, 0, 0, 0,0, 0, 1, 1, 1,1, 0, 0, 0, 0,0, 1, 0, 1, 0,0, 0, 0, 1, 1,1, 0],
        [0, 0, 1, 1, 1,0, 0, 1, 0, 0,0, 1, 0, 0, 0,0, 0, 0, 0, 0,0, 0, 0, 0, 0,0, 1, 0, 1, 0,0, 0, 1, 1, 1,0, 0],
        [0, 0, 0, 1, 1,1, 0, 1, 0, 1,0, 1, 1, 1, 1,1, 1, 1, 1, 1,1, 1, 1, 1, 1,1, 1, 1, 0, 1,0, 0, 1, 1, 1,0, 0],
        [0, 0, 0, 0, 1,1, 1, 1, 0, 0,0, 0, 0, 0, 0,0, 0, 0, 0, 0,0, 0, 0, 0, 0,0, 0, 0, 1, 0,1, 1, 1, 0, 0,0, 0],
        [0, 0, 0, 0, 0,1, 1, 1, 0, 0,0, 0, 1, 1, 1,1, 1, 1, 1, 1,1, 1, 1, 0, 1,1, 0, 0, 1, 1,1, 1, 0, 0, 0,0, 0],
        [0, 0, 0, 0, 0,0, 1, 1, 1, 0,0, 0, 1, 1, 1,1, 1, 1, 1, 1,1, 1, 1, 0, 1,1, 0, 0, 1, 1,1, 0, 0, 0, 0,0, 0],
        [1, 1, 1, 1, 1,0, 0, 1, 1, 1,0, 0, 0, 0, 0,0, 0, 0, 0, 0,0, 0, 0, 0, 0,0, 0, 0, 1, 1,0, 0, 0, 0, 0,0, 0],
        [1, 1, 1, 1, 1,0, 0, 1, 1, 1,0, 0, 0, 0, 1,1, 0, 0, 0, 0,0, 1, 0, 0, 1,1, 0, 0, 1, 0,0, 1, 1, 1, 1,1, 1],
        [0, 0, 0, 1, 1,0, 0, 1, 0, 0,0, 0, 0, 0, 1,1, 0, 0, 0, 0,1, 1, 1, 0, 1,1, 0, 0, 1, 0,0, 1, 1, 1, 1,1, 1],
        [1, 1, 0, 1, 1,0, 0, 1, 0, 0,0, 0, 1, 1, 1,1, 1, 1, 0, 0,0, 0, 0, 0, 0,0, 0, 0, 1, 0,0, 1, 1, 0, 0,0, 0],
        [0, 1, 0, 1, 1,0, 0, 1, 0, 0,0, 0, 1, 1, 1,1, 1, 1, 0, 0,0, 0, 1, 1, 1,0, 0, 0, 1, 0,0, 1, 1, 0, 1,1, 1],
        [0, 1, 0, 1, 1,0, 0, 1, 0, 0,0, 0, 0, 0, 1,1, 0, 0, 0, 0,0, 1, 1, 1, 1,1, 0, 0, 1, 1,0, 1, 1, 0, 1,0, 0],
        [0, 1, 0, 1, 1,0, 0, 1, 0, 0,0, 0, 0, 0, 1,1, 0, 0, 0, 0,0, 1, 1, 1, 1,1, 0, 0, 1, 1,1, 1, 0, 1, 1,1],
        [0, 1, 0, 1, 1,0, 1, 1, 1, 0,1, 1, 0, 0, 0,0, 0, 1, 1, 1,1, 0, 0, 0, 0,1, 1, 1, 1, 0,0, 1, 1, 0, 1,0],
        [0, 1, 0, 1, 1,0, 1, 0, 1, 0,1, 1, 0, 0, 0,0, 0, 0, 1, 1,1, 0, 0, 0, 0,0, 1, 1, 1, 0,0, 1, 1, 0, 1,0, 0],
        [0, 1, 0, 1, 1,0, 1, 0, 1, 0,1, 1, 0, 0, 0,0, 0, 0, 0, 0,0, 0, 0, 0, 0,0, 0, 0, 0, 0,0, 1, 1, 0, 1,0],
        [0, 1, 0, 1, 1,0, 1, 0, 1, 0,1, 1, 0, 0, 0,0, 0, 0, 0, 0,0, 1, 1, 0, 0,0, 0, 0, 0, 0,0, 0, 1, 1, 0,1, 0],
        [0, 1, 0, 1, 1,0, 1, 0, 1, 0,1, 1, 0, 0, 0,0, 0, 0, 0, 0,0, 1, 1, 0, 0,0, 0, 0, 0, 0,0, 0, 1, 1, 0,1, 0],
        [0, 1, 0, 1, 1,0, 1, 0, 1, 0,1, 1, 0, 0, 0,0, 0, 0, 0, 0,0, 1, 1, 0, 0,0, 0, 0, 0, 0,0, 0, 1, 1, 0,1, 0],
        [0, 1, 0, 1, 1,0, 1, 0, 1, 0,1, 1, 0, 0, 0,0, 0, 0, 0, 0,0, 0, 0, 0, 0,0, 0, 0, 0, 0,0, 1, 1, 0, 1,0]]
  },
    {
      "name": "noface",
      "pattern":[[0, 0, 0, 0, 0, 0, 0, 0, 0, 0, 0, 0, 0, 0, 0, 0, 0, 0, 0, 0, 0, 0],
        [0, 0, 0, 0, 1, 1, 1, 1, 1, 1, 1, 1, 0, 0, 0, 0, 0, 0, 0, 0, 0, 0],
        [0, 0, 0, 1, 1, 1, 1, 1, 1, 1, 1, 1, 1, 0, 0, 0, 0, 0, 0, 0, 0, 0],
        [0, 0, 0, 1, 1, 0, 0, 0, 0, 0, 1, 1, 1, 0, 0, 0, 0, 0, 0, 0, 0, 0],
        [0, 0, 1, 1, 0, 0, 1, 0, 0, 1, 0, 0, 1, 1, 1, 0, 0, 0, 0, 0, 0, 0],
        [0, 0, 1, 1, 0, 1, 1, 0, 0, 1, 1, 0, 1, 1, 1, 0, 0, 0, 0, 0, 0, 0],
        [0, 0, 1, 1, 0, 0, 0, 0, 0, 0, 0, 0, 1, 1, 1, 1, 0, 0, 0, 0, 0, 0],
        [0, 0, 1, 1, 0, 1, 1, 0, 0, 1, 1, 0, 1, 1, 1, 1, 1, 0, 0, 0, 0, 0],
        [0, 0, 1, 1, 0, 0, 0, 0, 0, 0, 0, 0, 1, 1, 1, 1, 1, 0, 0, 0, 0, 0],
        [0, 0, 1, 1, 0, 1, 1, 0, 0, 1, 1, 0, 1, 1, 1, 1, 1, 1, 0, 0, 0, 0],
        [0, 0, 1, 1, 0, 1, 1, 0, 0, 1, 1, 0, 1, 1, 1, 1, 1, 1, 1, 0, 0, 0],
        [0, 0, 1, 1, 0, 0, 1, 0, 0, 1, 0, 0, 1, 1, 1, 1, 1, 1, 1, 0, 0, 0],
        [0, 0, 1, 1, 0, 0, 0, 0, 0, 0, 0, 0, 1, 1, 1, 1, 1, 1, 1, 1, 0, 0],
        [0, 1, 1, 1, 1, 0, 0, 1, 1, 0, 0, 1, 1, 1, 1, 1, 1, 1, 1, 1, 1, 0],
        [0, 1, 1, 1, 1, 1, 0, 0, 0, 0, 1, 1, 1, 1, 1, 1, 1, 1, 1, 1, 1, 0],
        [0, 1, 1, 1, 1, 1, 1, 1, 1, 1, 1, 1, 1, 1, 1, 1, 1, 1, 1, 1, 1, 0],
        [0, 1, 1, 1, 1, 1, 1, 1, 1, 1, 1, 1, 1, 1, 1, 1, 1, 1, 1, 1, 1, 1],
        [1, 1, 1, 1, 1, 1, 1, 1, 1, 1, 1, 1, 1, 1, 1, 1, 1, 1, 1, 1, 1, 1],
        [1, 1, 1, 1, 1, 1, 1, 1, 1, 1, 1, 1, 1, 1, 1, 1, 1, 1, 1, 1, 1, 1],
        [1, 1, 1, 1, 1, 1, 1, 1, 1, 1, 1, 1, 1, 1, 1, 1, 1, 1, 1, 1, 1, 1],
        [1, 1, 1, 1, 1, 1, 1, 1, 1, 1, 1, 1, 1, 1, 1, 1, 1, 1, 1, 1, 1, 1],
        [1, 1, 1, 1, 1, 1, 1, 1, 1, 1, 1, 1, 1, 1, 1, 1, 1, 1, 1, 1, 1, 1]]
    }
  ]
}

